{
  "indicies": [
    [ 1, 1, 1, 1, 1, 1, 1, 1, 1, 1, 1, 1, 1, 1 ],
    [ 1, 0, 9, -1, -1, -1, -1, 4, -1, -1, -1, -1, -1, 1 ],
    [ 1, -1, 1, -1, 1, 1, 1, 1, 1, 1, 1, 1, -1, 1 ],
    [ 1, -1, 1, -1, -1, -1, -1, -1, -1, -1, -1, 1, -1, 1 ],
    [ 1, -1, 1, -1, -1, -1, -1, -1, -1, -1, -1, 1, -1, 1 ],
    [ 1, 4, 1, -1, 1, -1, -1, -1, -1, 1, -1, 1, 4, 1 ],
    [ 1, -1, 1, -1, 1, -1, -1, -1, -1, 1, -1, 1, -1, 1 ],
    [ 1, -1, 1, -1, -1, -1, -1, -1, -1, -1, -1, 1, -1, 1 ],
    [ 1, -1, 1, -1, -1, -1, -1, -1, -1, -1, -1, 1, -1, 1 ],
    [ 1, -1, 1, 1, 1, 1, 1, 1, 1, 1, -1, 1, -1, 1 ],
    [ 1, -1, -1, -1, -1, -1, 4, -1, -1, -1, -1, 8, 0, 1 ],
    [ 1, 1, 1, 1, 1, 1, 1, 1, 1, 1, 1, 1, 1, 1 ]
  ],
  "rows": 12,
  "cols": 14
}