{
  "indicies": [
    [ 1, 0, 1, 1, 1, 1, 1, 1, 1, 1, 1, 1, 1, 1 ],
    [ 1, 0, 1, -1, -1, -1, -1, -1, -1, -1, -1, -1, -1, 1 ],
    [ 1, 0, 1, -1, -1, -1, -1, 1, -1, -1, -1, -1, -1, 1 ],
    [ 1, 0, 1, -1, -1, 1, 1, 1, 1, -1, -1, -1, -1, 1 ],
    [ 1, -1, 1, -1, 1, 1, 1, 6, 1, -1, -1, -1, -1, 1 ],
    [ 1, -1, 1, -1, 1, 1, 1, 6, 1, -1, -1, -1, -1, 1 ],
    [ 1, -1, 1, -1, 1, 1, 1, 1, 1, -1, -1, -1, -1, 1 ],
    [ 1, -1, 1, -1, -1, -1, -1, -1, -1, -1, -1, -1, -1, 1 ],
    [ 1, -1, 1, -1, -1, 1, 1, -1, -1, -1, -1, -1, -1, 1 ],
    [ 1, -1, -1, -1, -1, 1, 1, -1, -1, -1, -1, -1, -1, 1 ],
    [ 1, 1, 1, 1, 1, 1, 1, -1, -1, -1, -1, -1, -1, 1 ],
    [ 1, 1, 1, 1, 1, 1, 1, -1, -1, -1, -1, -1, -1, 1 ]
  ],
  "rows": 12,
  "cols": 14
}