{"indicies":[
  [1, -1,  3, -1, -1, -1, -1, -1, -1, -1, -1, -1, -1, -1, -1,  1], 
  [1, -1, -1, -1, -1, -1, -1, -1, -1, -1, -1, -1, -1, -1, -1,  1], 
  [3, -1,  1,  0,  0,  1, -1, -1, -1, -1, -1, -1, -1, -1, -1,  1], 
  [1, -1, -1,  1,  1, -1, -1, -1, -1, -1, -1, -1, -1, -1, -1,  1], 
  [1, -1, -1, -1, -1, -1, -1, -1, -1, -1,  2, -1,  0, -1,  0,  1], 
  [1,  1, -1, -1, -1, -1, -1, -1, -1, -1, -1,  5,  1,  5,  1,  1], 
  [1,  2,  1, -1, -1, -1, -1, -1, -1, -1, -1, -1, -1,  1,  2,  1], 
  [1,  2,  2,  1, -1, -1, -1, -1, -1, -1, -1, -1,  1,  2,  2,  1], 
  [1,  1,  1,  1,  1, -1, -1, -1, -1, -1, -1,  1,  1,  1,  1,  1]
], "rows":9, "cols":16}